R 1300 900

NO ./scenes/textures/64/diamand.xpm
EA ./scenes/textures/64/redbrick.xpm
WE ./scenes/textures/64/greystone.xpm
SO ./scenes/textures/64/eagle.xpm

S ./scenes/textures/64/pillar.xpm


F 0,30,0
C 100,5,220


        1111111111111111111111111
        1000000000110000000000021
        1011000001110000000000001
        1001000000000000000000001
11111111100000001110000000000001
100000000011000001110111111111111
11110111111111011100000010001
11110111111111011101010010001
11000000110101011100000010001
10000000000200001100000010001
10N0002002000001101010010001
11000001110101011111011110001
11110111 1110101 101111010001
11111111 1111111 111111111111