R	1000	1080
NO ./maps/texturesbluestone.xpm
SO ./maps/texturesgreystone.xpm
WE ./maps/texturespurplestone.xpm
EA ./maps/texturesredbrick.xpm
S ./maps/texturesbarrel.xpm

F 255,0,55
C 0,128,8

1111111111111111111111111111111111111111111
1000000000000000000000000000000002000002001
1000000000000000000000000000000000002000001
1000111111111111111111111111111111111111111
1000100000000001000000000111111111110000111
1000100000000001000000000111111111110000111
100010000W000001000000000000001111110000111
1000100000000001000000000000000001110000111
1000100000000001000000000000000000000000111
1000100000000000000000000000000000000000111
1000111111111111111111111111111111110000111
1000111111111111111111111111111111110000111
1000000000000000000000000000000000000000101
1000000000000000000000000000000000000000111
1111111111111111111111111111111111111111111
