R 1000 600

NO ./maps/textures/64/diamand.xpm
EA ./maps/textures/64/redbrick.xpm
WE ./maps/textures/64/greystone.xpm
SO ./maps/textures/64/eagle.xpm

S ./maps/textures/64/pillar.xpm


F 220,100,0
C 225,30,0

11111111111111111111111111111
10000000000000000000000000001
10000010000000000000000000001
10000000000000000000010000001
10000000000000000000000000001
1000W000000000000000000000001
10000000000001000000000010001
10000000000000000000000000001
10000000000000000000000000001
10000000000000000000000000001
10000010000000000000000000001
10000000000000000001000000001
11111111111111111111111111111