R	1920	1080
NO ./maps/textures/64/64/bluestone.xpm
SO ./maps/textures/64/64/greystone.xpm
WE ./maps/textures/64/64/purplestone.xpm
EA ./maps/textures/64/64/redbrick.xpm
S ./maps/textures/64/64/barrel.xpm

F 24,85,2
C 29,25,01

11111111111111111111111111111111
10000111100000000000000000000001
1E000020000020022220000200011111
1000000000000000000000000001
1000000000000000020000000001
1111111111111111111111111111
